13 13 13 13 13 13 13 13 13 13 13 13 13 13 13 13 13 13 13 13 13 13 13 13 13 13 13 13 13 13 13 13 13 13 13 13 13 13 13 13 13 13 13 13 13 13 13 13 13 13 13 13 13 13 13 13 13 13 13 13 13 13 13
13 13 13 13 13 13 13 13 13 13 13 13 13 13 13 13 13 13 13 13 13 13 13 13 13 13 13 13 13 13 13 13 13 13 13 13 13 13 13 13 13 13 13 13 13 13 13 13 13 13 13 13 13 13 13 13 13 13 13 13 13 13 13
13 13 13 13 13 13 13 13 13 13 13 13 13 13 13 13 13 13 13 13 13 13 13 13 13 13 13 13 13 13 13 13 13 13 13 13 13 13 13 13 13 13 13 13 13 13 13 13 13 13 13 13 13 13 13 13 13 13 13 13 13 13 13
13 13 13 13 13 13 13 13 13 13 13 13 13 13 13 13 13 13 13 13 13 13 13 13 13 13 13 13 13 13 13 13 13 13 13 13 13 13 13 13 13 13 13 13 13 13 13 13 13 13 13 13 13 13 13 13 13 13 13 13 13 13 13
13 13 13 13 13 13 13 13 13 13 13 13 13 13 13 13 13 13 13 13 13 13 13 13 13 13 13 13 13 13 13 13 13 13 13 13 13 13 13 13 13 13 13 13 13 13 13 13 13 13 13 13 13 13 13 13 13 13 13 13 13 13 13
13 13 13 13 13 13 13 13 27 20 20 20 20 20 20 20 20 20 20 20 20 20 20 20 20 20 20 20 20 20 20 20 20 20 20 20 20 20 20 20 20 20 20 20 20 20 20 20 20 20 20 20 28 13 13 13 13 13 13 13 13 13 13
13 13 13 13 13 13 13 13 22 10 10 10 10 10 10 10 10 10 10 10 10 10 10 10 10 10 10 10 10 10 10 10 10 10 10 10 10 10 10 10 10 10 10 10 10 10 10 10 10 10 10 10 21 13 13 13 13 13 13 13 13 13 13
13 13 13 13 13 13 13 13 22 10 10 10 10 10 10 10 10 10 10 10 10 10 10 10 10 10 10 10 10 10 10 10 10 10 10 10 10 10 10 10 10 10 10 10 10 10 10 10 10 10 10 10 21 13 13 13 13 13 13 13 13 13 13
13 13 13 13 13 13 13 13 22 10 10 10 10 10 10 10 10 10 10 10 10 10 10 10 10 10 10 10 10 10 10 10 10 10 10 10 10 10 10 10 10 10 10 10 10 10 10 10 10 10 10 10 21 13 13 13 13 13 13 13 13 13 13
13 13 13 13 13 13 13 13 22 10 10 10 10 11 11 11 11 11 11 11 11 11 11 11 11 11 11 11 11 11 11 11 11 11 11 11 11 11 11 10 10 10 10 10 10 10 10 10 10 10 10 10 21 13 13 13 13 13 13 13 13 13 13
13 13 13 13 13 13 13 13 22 10 10 10 10 11 15 15 15 15 15 15 15 15 15 15 15 15 15 15 15 15 15 15 15 15 15 15 10 15 11 10 10 10 10 10 10 10 10 10 10 10 10 10 21 13 13 13 13 13 13 13 13 13 13
13 13 13 13 13 13 13 13 22 10 10 10 10 11 15 10 10 10 10 10 10 10 10 10 10 10 10 15 10 10 10 15 10 10 10 15 10 15 11 10 10 10 10 10 10 10 10 10 10 10 10 10 21 13 13 13 13 13 13 13 13 13 13
13 13 13 13 13 13 13 13 22 10 10 10 10 11 15 10 15 15 15 15 15 15 15 15 15 15 10 15 10 15 10 15 10 15 10 15 10 15 11 10 10 10 10 10 10 10 10 10 10 10 10 10 21 13 13 13 13 13 13 13 13 13 13
13 13 13 13 13 13 13 13 22 10 10 10 10 11 15 10 10 10 10 10 10 10 10 10 10 15 10 10 10 15 10 15 10 15 10 15 10 15 11 10 10 10 10 10 10 10 10 10 10 10 10 10 21 13 13 13 13 13 13 13 13 13 13
13 13 13 13 13 13 13 13 22 10 10 10 10 11 15 15 15 15 15 15 15 15 15 15 10 15 15 15 15 15 10 15 10 15 10 15 10 15 11 10 10 10 10 10 10 10 10 10 10 10 10 10 21 13 13 13 13 13 13 13 13 13 13
13 13 13 13 13 13 13 13 22 10 10 10 10 11 15 10 10 10 10 10 10 10 10 10 10 15 10 10 10 15 10 15 10 15 10 15 10 15 11 10 10 10 10 10 10 10 10 10 10 10 10 10 21 13 13 13 13 13 13 13 13 13 13
13 13 13 13 13 13 13 13 22 10 10 10 10 11 15 10 15 15 15 15 15 15 15 15 15 15 10 15 10 15 10 15 10 15 10 15 10 15 11 10 10 10 10 10 10 10 10 10 10 10 10 10 21 13 13 13 13 13 13 13 13 13 13
13 13 13 13 13 13 13 13 22 10 10 10 10 11 15 10 15 15 10 10 10 15 10 10 10 15 10 15 10 15 10 15 10 15 10 15 10 15 11 10 10 10 10 10 10 10 10 10 10 10 10 10 21 13 13 13 13 13 13 13 13 13 13
13 13 13 13 13 13 13 13 22 10 10 10 10 11 15 10 15 15 10 15 10 15 10 15 10 15 10 15 10 15 10 15 10 15 10 15 10 15 11 10 10 10 10 10 10 10 10 10 10 10 10 10 21 13 13 13 13 13 13 13 13 13 13
13 13 13 13 13 13 13 13 22 10 10 10 10 11 15 10 10 10 10 15 10 10 10 15 10 10 10 15 10 15 10 10 10 15 10 10 10 15 11 10 10 10 10 10 10 10 10 10 10 10 10 10 21 13 13 13 13 13 13 13 13 13 13
13 13 13 13 13 13 13 13 22 10 10 10 10 11 15 15 15 15 15 15 15 15 15 15 15 15 15 15 15 15 15 15 15 15 15 15 15 15 11 10 10 10 10 10 10 10 10 10 10 10 10 10 21 13 13 13 13 13 13 13 13 13 13
13 13 13 13 13 13 13 13 22 10 10 10 10 11 11 11 11 11 11 11 11 11 11 11 11 11 11 11 11 11 11 11 11 11 11 11 11 11 11 10 10 10 10 10 10 10 10 10 10 10 10 10 21 13 13 13 13 13 13 13 13 13 13
13 13 13 13 13 13 13 13 22 10 10 10 10 11 15 15 15 15 15 15 15 15 15 15 15 15 15 15 15 15 11 15 15 15 15 15 15 15 11 10 10 10 10 10 10 10 10 10 10 10 10 10 21 13 13 13 13 13 13 13 13 13 13
13 13 13 13 13 13 13 13 22 10 10 10 10 11 15 15 10 10 10 10 10 10 10 10 10 10 10 10 10 15 11 15 10 10 10 10 10 15 11 10 10 10 10 10 10 10 10 10 10 10 10 10 21 13 13 13 13 13 13 13 13 13 13
13 13 13 13 13 13 13 13 22 10 10 10 10 11 15 15 10 15 15 15 15 15 15 15 15 15 15 15 10 15 11 15 10 15 15 15 10 15 11 10 10 10 10 10 10 10 10 10 10 10 10 10 21 13 13 13 13 13 13 13 13 13 13
13 13 13 13 13 13 13 13 22 10 10 10 10 11 11 15 10 10 10 10 10 10 10 10 10 10 10 15 10 15 11 15 10 15 10 15 10 15 11 10 10 10 10 10 10 10 10 10 10 10 10 10 21 13 13 13 13 13 13 13 13 13 13
13 13 13 13 13 13 13 13 22 10 10 10 10 10 11 11 15 15 15 15 15 15 15 15 15 15 10 15 10 15 11 10 10 15 10 15 10 15 11 10 10 10 10 10 10 10 10 10 10 10 10 10 21 13 13 13 13 13 13 13 13 13 13
13 13 13 13 13 13 13 13 22 10 10 10 10 10 10 11 15 10 10 10 10 10 10 10 10 10 10 15 10 15 11 15 15 15 10 15 10 15 11 10 10 10 10 10 10 10 10 10 10 10 10 10 21 13 13 13 13 13 13 13 13 13 13
13 13 13 13 13 13 13 13 22 10 10 10 10 10 10 11 15 15 15 15 15 15 15 15 15 15 15 15 10 15 11 15 15 15 10 15 10 15 11 10 10 10 10 10 10 10 10 10 10 10 10 10 21 13 13 13 13 13 13 13 13 13 13
13 13 13 13 13 13 13 13 22 10 10 10 10 10 10 11 11 10 10 10 10 10 10 10 10 10 10 10 10 15 11 15 15 15 10 10 10 15 11 10 10 10 10 10 10 10 10 10 10 10 10 10 21 13 13 13 13 13 13 13 13 13 13
13 13 13 13 13 13 13 13 22 10 10 10 10 10 10 10 11 15 15 15 15 15 15 15 15 15 15 15 15 15 11 15 15 15 15 15 15 15 11 10 10 10 10 10 10 10 10 10 10 10 10 10 21 13 13 13 13 13 13 13 13 13 13
13 13 13 13 13 13 13 13 22 10 10 10 10 10 10 10 11 11 11 11 11 11 11 11 11 11 11 11 11 11 11 11 11 11 11 11 11 11 11 11 11 11 11 11 11 10 10 10 10 10 10 10 21 13 13 13 13 13 13 13 13 13 13
13 13 13 13 13 13 13 13 22 10 10 10 10 10 10 10 11 15 15 15 15 15 15 15 15 15 15 15 15 15 11 15 15 15 15 15 15 15 15 15 15 15 15 15 11 10 10 10 10 10 10 10 21 13 13 13 13 13 13 13 13 13 13
13 13 13 13 13 13 13 13 22 10 10 10 10 10 10 10 11 15 15 15 15 15 15 15 15 15 15 15 15 15 11 15 10 10 10 10 10 10 10 10 10 10 10 10 11 10 10 10 10 10 10 10 21 13 13 13 13 13 13 13 13 13 13
13 13 13 13 13 13 13 13 22 10 10 10 10 10 10 10 11 15 15 15 15 15 15 15 15 15 15 15 15 15 11 15 10 15 15 15 15 15 15 15 15 15 15 15 11 10 10 10 10 10 10 10 21 13 13 13 13 13 13 13 13 13 13
13 13 13 13 13 13 13 13 22 10 10 10 10 10 10 10 11 15 15 15 15 15 15 15 15 15 15 15 15 15 11 15 10 15 10 10 10 10 10 10 10 10 10 15 11 10 10 10 10 10 10 10 21 13 13 13 13 13 13 13 13 13 13
13 13 13 13 13 13 13 13 22 10 10 10 10 10 10 10 11 15 15 15 15 15 15 15 15 15 15 15 15 15 11 15 10 15 10 15 15 15 15 15 15 15 10 15 11 10 10 10 10 10 10 10 21 13 13 13 13 13 13 13 13 13 13
13 13 13 13 13 13 13 13 22 10 10 10 10 10 10 10 11 11 11 11 11 11 15 15 15 15 15 15 15 15 11 15 10 15 10 10 10 10 10 10 10 15 10 15 11 10 10 10 10 10 10 10 21 13 13 13 13 13 13 13 13 13 13
13 13 13 13 13 13 13 13 22 10 10 10 10 10 10 10 10 10 10 10 10 11 15 15 15 15 15 15 15 15 11 15 10 15 15 15 15 15 15 15 15 15 10 15 11 10 10 10 10 10 10 10 21 13 13 13 13 13 13 13 13 13 13
13 13 13 13 13 13 13 13 22 10 10 10 10 10 10 10 10 10 10 10 10 11 15 15 15 15 15 15 15 15 11 15 10 10 10 10 10 10 10 10 10 10 10 15 11 10 10 10 10 10 10 10 21 13 13 13 13 13 13 13 13 13 13
13 13 13 13 13 13 13 13 22 10 10 10 10 10 10 10 10 10 10 10 10 11 15 15 15 15 15 15 15 15 11 15 15 15 15 15 15 15 15 15 15 15 15 15 11 10 10 10 10 10 10 10 21 13 13 13 13 13 13 13 13 13 13
13 13 13 13 13 13 13 13 22 10 10 10 10 10 10 10 10 10 10 10 10 11 15 15 15 15 15 15 15 15 11 11 11 11 11 11 11 11 11 11 11 11 11 11 11 10 10 10 10 10 10 10 21 13 13 13 13 13 13 13 13 13 13
13 13 13 13 13 13 13 13 22 10 10 10 10 10 10 10 10 10 10 10 10 11 15 15 15 15 15 15 15 15 11 10 10 10 10 10 10 10 10 10 10 10 10 10 10 10 10 10 10 10 10 10 21 13 13 13 13 13 13 13 13 13 13
13 13 13 13 13 13 13 13 22 10 10 10 10 10 10 10 10 10 10 10 10 11 15 15 15 15 15 15 15 15 11 10 10 10 10 10 10 10 10 10 10 10 10 10 10 10 10 10 10 10 10 10 21 13 13 13 13 13 13 13 13 13 13
13 13 13 13 13 13 13 13 22 10 10 10 10 10 10 10 10 10 10 10 10 11 15 15 15 15 15 15 15 15 11 10 10 10 10 10 10 10 10 10 10 10 10 10 10 10 10 10 10 10 10 10 21 13 13 13 13 13 13 13 13 13 13
13 13 13 13 13 13 13 13 22 10 10 10 10 10 10 10 10 10 10 10 10 11 11 11 11 11 11 11 11 11 11 10 10 10 10 10 10 10 10 10 10 10 10 10 10 10 10 10 10 10 10 10 21 13 13 13 13 13 13 13 13 13 13
13 13 13 13 13 13 13 13 22 10 10 10 10 10 10 10 10 10 10 10 10 10 10 10 10 10 10 10 10 10 10 10 10 10 10 10 10 10 10 10 10 10 10 10 10 10 10 10 10 10 10 10 21 13 13 13 13 13 13 13 13 13 13
13 13 13 13 13 13 13 13 22 10 10 10 10 10 10 10 10 10 10 10 10 10 10 10 10 10 10 10 10 10 10 10 10 10 10 10 10 10 10 10 10 10 10 10 10 10 10 10 10 10 10 10 21 13 13 13 13 13 13 13 13 13 13
13 13 13 13 13 13 13 13 22 10 10 10 10 10 10 10 10 10 10 10 10 10 10 10 10 10 10 10 10 10 10 10 10 10 10 10 10 10 10 10 10 10 10 10 10 10 10 10 10 10 10 10 21 13 13 13 13 13 13 13 13 13 13
13 13 13 13 13 13 13 13 29 19 19 19 19 19 19 19 19 19 19 19 19 19 19 19 19 19 19 19 19 19 19 19 19 19 19 19 19 19 19 19 19 19 19 19 19 19 19 19 19 19 19 19 30 13 13 13 13 13 13 13 13 13 13
13 13 13 13 13 13 13 13 13 13 13 13 13 13 13 13 13 13 13 13 13 13 13 13 13 13 13 13 13 13 13 13 13 13 13 13 13 13 13 13 13 13 13 13 13 13 13 13 13 13 13 13 13 13 13 13 13 13 13 13 13 13 13
13 13 13 13 13 13 13 13 13 13 13 13 13 13 13 13 13 13 13 13 13 13 13 13 13 13 13 13 13 13 13 13 13 13 13 13 13 13 13 13 13 13 13 13 13 13 13 13 13 13 13 13 13 13 13 13 13 13 13 13 13 13 13
13 13 13 13 13 13 13 13 13 13 13 13 13 13 13 13 13 13 13 13 13 13 13 13 13 13 13 13 13 13 13 13 13 13 13 13 13 13 13 13 13 13 13 13 13 13 13 13 13 13 13 13 13 13 13 13 13 13 13 13 13 13 13
13 13 13 13 13 13 13 13 13 13 13 13 13 13 13 13 13 13 13 13 13 13 13 13 13 13 13 13 13 13 13 13 13 13 13 13 13 13 13 13 13 13 13 13 13 13 13 13 13 13 13 13 13 13 13 13 13 13 13 13 13 13 13
13 13 13 13 13 13 13 13 13 13 13 13 13 13 13 13 13 13 13 13 13 13 13 13 13 13 13 13 13 13 13 13 13 13 13 13 13 13 13 13 13 13 13 13 13 13 13 13 13 13 13 13 13 13 13 13 13 13 13 13 13 13 13
13 13 13 13 13 13 13 13 13 13 13 13 13 13 13 13 13 13 13 13 13 13 13 13 13 13 13 13 13 13 13 13 13 13 13 13 13 13 13 13 13 13 13 13 13 13 13 13 13 13 13 13 13 13 13 13 13 13 13 13 13 13 13
13 13 13 13 13 13 13 13 13 13 13 13 13 13 13 13 13 13 13 13 13 13 13 13 13 13 13 13 13 13 13 13 13 13 13 13 13 13 13 13 13 13 13 13 13 13 13 13 13 13 13 13 13 13 13 13 13 13 13 13 13 13 13
13 13 13 13 13 13 13 13 13 13 13 13 13 13 13 13 13 13 13 13 13 13 13 13 13 13 13 13 13 13 13 13 13 13 13 13 13 13 13 13 13 13 13 13 13 13 13 13 13 13 13 13 13 13 13 13 13 13 13 13 13 13 13
13 13 13 13 13 13 13 13 13 13 13 13 13 13 13 13 13 13 13 13 13 13 13 13 13 13 13 13 13 13 13 13 13 13 13 13 13 13 13 13 13 13 13 13 13 13 13 13 13 13 13 13 13 13 13 13 13 13 13 13 13 13 13
13 13 13 13 13 13 13 13 13 13 13 13 13 13 13 13 13 13 13 13 13 13 13 13 13 13 13 13 13 13 13 13 13 13 13 13 13 13 13 13 13 13 13 13 13 13 13 13 13 13 13 13 13 13 13 13 13 13 13 13 13 13 13